RET	keep
ERM	keep
ZMA	keep
MAN	remo
OLB	remo
D10	remo
BGC	remo
OLA	remo
NAG	remo
PG4	remo
BOG	remo
1WV	remo
Y01	remo
BMA	remo
NDG	remo
TRE	remo
BF0	keep
1PE	remo
CAU	keep
JDC	keep
EJ4	keep
2U8	keep
I32	keep
2CV	remo
MHA	remo
SO4	remo
PEG	remo
 NA	remo
 CL	remo
 ZN	remo
ACE	remo
HOH	remo
GOL	remo
PO4	remo
DMS remo
1PE remo
PO4 remo
YCM remo
MES remo
